1111111111111
1000000000001
1001C11111001
1001000000001
1001000000001
10P0111110111
10011E0000011
1111111111111