1111111111111
1000000000001
1001C11111001
1001000000001
1001000000001
1001011111001
1P0101E000001
1111111111111
