0111111111111
1000000000001
1000000011001
10000E0000001
1000000000001
1000001110111
1P000000000C1
1111111111111