1111111111111
1000000000001
1001011111001
1001000000001
100100000C001
1000111110111
1P011E0000001
1111111111111