1111111111111
10000000C00P1
1001011111001
10010000C0001
1001000010001
1000111110111
10011E00000C1
1111111111111