1111111111111
1C00000000001
1001C11111001
1001000000001
100100000C001
1000111110111
1P011000000E1
1111111111111