1111111111111
10000100000P1
1000001111001
10000000C0001
1000000000001
1000000000011
10011E0000YC1
1111111111111