1111111111111
1000Y000C00P1
1000001111001
10000000C0001
1Y00000000001
1000000000011
10011E00000C1
1111111111111